Тоттенхэм - Вест Хэм                - обе забьют       +
Фулхэм - Астон Вилла                - обе забьют       +
Ипсвич Таун - Эвертон               - обе забьют       -
Манчестер Юнайтед - Брентфорд       - юнайтед тотал 1,5    +
Ньюкасл - Брайтон                   - обе забьт            -
Саутгемптон - Лестер Сити           - лестр 1,5, победа лестера ++
Борнмут - Арсенал                   - арсенал тотал 1,5        -
Вулверхэмптон - Манчестер Сити      - обе забьют (риск) тотал 1,5 Сити ++
Ливерпуль - Челси                   - обе забьют победа Челси (риск) +-
НоттингемФорест - КристалПэлас      - no data

Алавес - Реал Вальядолид            - обе забьют (риск)     +
Атлетик - Эспаньол                  - бильбао 1,5           +
Осасуна - Бетис                     - оссасуна 1,5          -
Жирона - Реал Сосьедад              - жирона 1,5            -
Сельта - Реал Мадрид                - обе забьют реал 1,5   +
Мальорка - Райо Вальекано           - обе забьют            -
Атлетико Мадрид - Леганес           - тоатл мадрид 1,5      +
Вильярреал - Хетафе                 - тотал 1,5             +
Барселона - Севилья                 - тотал 1,5             +
Валенсия - Лас-Пальмас              - тотал 1,5, обе забьют +

____________________________________________________________________________
Лестер Сити - Ноттингем Форест     - both score        p     +
Астон Вилла - Борнмут              - total 1,5 game    p     +
Брентфорд - Ипсвич Таун            - total 1,5 game          +
Брайтон - Вулверхэмптон            - both score        p      +
Манчестер Сити - Саутгемптон       - total 1,5 Mcity   p      -
Эвертон - Фулхэм                   - both score        p      +
Челси - Ньюкасл                    - total 1,5 Chelsea        +
Кристал Пэлас - Тоттенхэм          - total 1,5 Tot, both score(risk)  p    -
Вест Хэм - Манчестер Юнайтед       - both score                +
Арсенал - Ливерпуль                - both score                 p          +

Эспаньол - Севилья                 - both score        p            -
Реал Вальядолид - Вильярреал       - both score        p            +
Райо Вальекано - Алавес            - total 1,5 game, both score     -
Лас-Пальмас - Жирона               - both score                     -
Реал Мадрид - Барселона            - both score, total 1,5 game    p -
Леганес - Сельта                   - both score                      -
Хетафе - Валенсия                  - total 1,5 game               p  +
Бетис - Атлетико Мадрид            - total 1,5 game, both score   p   -
Реал Сосьедад - Осасуна            - total 1,5 game               p   +
Мальорка - Атлетик                 - total 1,5 game, both score

Майнц - Боруссия Мёнхенгладбах      - no data
Штутгарт - Хольштайн Киль           - both score                    p           +
РБ Лейпциг - Фрайбург               - both score, total 1,5 game    p           +
Аугсбург - Боруссия Дортмунд        - both score                                 +
Санкт-Паули - Вольфсбург            - total 1,5 Volc                p            -
Вердер - Байер                      - both score(low risk)                       +
Бохум - Бавария                     - no data, total 1,5 Bav                     +
Унион Берлин - Айнтрахт Франкфурт   - both score, total 1,5 game     p           +
Хайденхайм - Хоффенхайм             - both score                                 -

Торино - Комо                       - torino score                  p    +


676522935550